{"#","#","#","#","#","#","#","#","#","#","#","#","#","#","#","#","#","#","#","#","#","#","#","#","#","#","#","#","#","#","#","#","#","#","#","#","#","#","#","#","#","#","#","#","#","#"},
{"#"," "," "," "," "," "," "," "," "," "," "," "," "," "," ","#"," "," "," "," "," "," "," "," "," "," "," "," "," "," "," "," "," "," "," "," "," "," "," "," "," "," "," "," "," ","#"},
{"#"," "," ","#","#","#","#","#","#","#","#","#","#"," "," ","#","#","#","#","#","#","#","#","#","#","#","#","#"," "," ","#","#","#","#","#","#","#"," "," ","#","#","#","#"," "," ","#"},
{"#"," "," "," "," "," "," "," "," "," "," "," ","#"," "," "," "," "," "," "," "," "," "," "," "," "," "," "," "," "," ","#"," "," "," "," "," "," "," "," ","#"," "," "," "," "," ","#"},
{"#"," "," ","#","#","#","#","#","#","#"," "," ","#","#","#","#","#","#","#","#","#","#","#","#","#"," "," ","#","#","#","#","#","#","#","#","#","#","#","#","#","#","#","#","#","#","#"},
{"#"," "," ","#"," "," "," "," "," ","#"," "," ","#"," "," "," "," "," "," "," "," "," "," "," ","#"," "," ","#"," "," "," "," "," "," "," "," "," "," "," "," "," "," "," "," "," ","#"},
{"#"," "," ","#"," "," ","#"," "," ","#"," "," ","#"," "," ","#"," "," ","#","#","#","#","#","#","#"," "," ","#"," "," ","#","#","#","#","#","#","#","#","#","#","#","#","#"," "," ","#"},
{"#"," "," ","#"," "," ","#"," "," ","#"," "," ","#"," "," ","#"," "," ","#"," "," "," "," "," ","#"," "," ","#"," "," ","#"," "," ","#"," "," "," "," "," "," "," "," ","#"," "," ","#"},
{"#"," "," ","#"," "," ","#","#","#","#"," "," ","#"," "," ","#","#","#","#","#","#","#","#","#","#"," "," ","#"," "," ","#","#","#","#"," "," ","#"," "," ","#"," "," ","#"," "," ","#"},
{"#"," "," ","#"," "," "," "," "," ","#"," "," ","#"," "," "," "," "," "," "," "," "," "," "," "," "," "," ","#"," "," "," "," "," "," "," "," "," "," "," ","#"," "," ","#"," "," ","#"},
{"#"," "," ","#","#","#","#"," "," ","#"," "," ","#","#","#","#","#","#","#","#","#","#","#","#","#","#","#","#"," "," ","#","#","#","#","#","#","#","#","#","#","#","#","#"," "," ","#"},
{"#"," "," "," "," "," ","#"," "," ","#"," "," "," "," "," "," "," "," "," "," "," "," "," "," "," "," "," "," "," "," ","#"," "," "," "," "," "," "," "," "," "," "," "," "," "," ","#"},
{"#","#","#","#"," "," ","#"," "," ","#","#","#","#","#","#","#","#","#","#","#","#","#","#","#","#","#","#","#","#","#","#"," "," ","#","#","#","#","#","#","#","#","#","#"," "," ","#"},
{"#"," "," ","#"," "," ","#"," "," "," "," "," "," "," "," "," "," "," "," "," "," "," "," "," "," "," "," ","#"," "," "," "," "," ","#"," "," "," "," "," ","#"," "," ","#"," "," ","#"},
{"#"," "," ","#"," "," ","#","#","#","#"," "," ","#","#","#","#","#","#","#","#","#","#","#","#","#"," "," ","#"," "," ","#","#","#","#"," "," ","#"," "," ","#"," "," ","#"," "," ","#"},
{"#"," "," ","#"," "," ","#"," "," "," "," "," ","#"," "," "," "," "," ","#"," "," "," "," "," ","#"," "," ","#"," "," ","#"," "," "," "," "," ","#"," "," "," "," "," ","#"," "," ","#"},
{"#"," "," ","#"," "," ","#"," "," ","#","#","#","#","#","#","#"," "," ","#","#","#","#"," "," ","#"," "," ","#"," "," ","#"," "," ","#","#","#","#","#","#","#","#","#","#"," "," ","#"},
{"#"," "," "," "," "," ","#"," "," ","#"," "," "," "," "," "," "," "," "," "," "," "," "," "," ","#"," "," ","#"," "," ","#"," "," "," "," "," "," "," "," "," "," "," "," "," "," ","#"},
{"#","#","#","#"," "," ","#"," "," ","#"," "," ","#","#","#","#","#","#","#","#","#","#"," "," ","#"," "," ","#"," "," ","#"," "," ","#","#","#","#","#","#","#","#","#","#","#","#","#"},
{"#"," "," ","#"," "," ","#"," "," ","#"," "," ","#"," "," ","#"," "," "," "," "," "," "," "," ","#"," "," ","#"," "," ","#"," "," ","#"," "," "," "," "," "," "," "," "," "," "," ","#"},
{"#"," "," ","#"," "," ","#"," "," ","#"," "," ","#"," "," ","#","#","#","#","#","#","#"," "," ","#"," "," ","#"," "," ","#"," "," ","#"," "," ","#","#","#","#","#","#","#"," "," ","#"},
{"#"," "," ","#"," "," ","#"," "," ","#"," "," ","#"," "," ","#"," "," "," "," "," ","#"," "," ","#"," "," ","#"," "," ","#"," "," ","#"," "," ","#"," "," "," "," "," ","#"," "," ","#"},
{"#"," "," ","#"," "," ","#"," "," ","#"," "," ","#"," "," ","#","#","#","#","#","#","#"," "," ","#"," "," ","#"," "," ","#"," "," ","#"," "," ","#"," "," ","#"," "," ","#"," "," ","#"},
{"#"," "," ","#"," "," ","#"," "," ","#"," "," ","#"," "," "," "," "," "," "," "," ","#"," "," ","#"," "," ","#"," "," ","#"," "," ","#"," "," ","#"," "," ","#"," "," ","#"," "," ","#"},
{"#"," "," ","#"," "," ","#"," "," ","#"," "," ","#","#","#","#","#","#","#","#","#","#","#","#","#"," "," ","#"," "," ","#"," "," ","#"," "," ","#","#","#","#"," "," ","#"," "," ","#"},
{"#"," "," "," "," "," ","#"," "," ","#"," "," "," "," "," "," "," "," "," "," "," "," "," "," "," "," "," ","#"," "," ","#"," "," ","#"," "," "," "," "," "," "," "," ","#"," "," ","#"},
{"#"," "," ","#","#","#","#"," "," ","#"," "," ","#","#","#","#","#","#","#","#","#","#","#","#","#","#","#","#"," "," ","#"," "," ","#","#","#","#","#","#","#"," "," ","#"," "," ","#"},
{"#"," "," ","#"," "," "," "," "," ","#"," "," ","#"," "," "," "," "," "," "," "," ","#"," "," "," "," "," "," "," "," ","#"," "," "," "," "," ","#"," "," "," "," "," ","#"," "," ","#"},
{"#"," "," ","#","#","#","#"," "," ","#"," "," ","#","#","#","#","#","#","#"," "," ","#"," "," ","#","#","#","#","#","#","#","#","#","#"," "," ","#","#","#","#","#","#","#"," "," ","#"},
{"#"," "," "," "," "," "," "," "," ","#"," "," "," "," "," "," "," "," "," "," "," ","#"," "," ","#"," "," "," "," "," "," "," "," "," "," "," "," "," "," "," "," "," "," "," "," ","#"},
{"#","#","#","#","#","#","#","#","#","#","#","#","#","#","#","#","#","#","#","#","#","#","#","#","#"," "," ","#","#","#","#","#","#","#","#","#","#","#","#","#","#","#","#","#","#","#"},
